+ + + + + + + + + + + + + + + +
+ + + + + + + + + + + + + + + +
+ + + + + + + + + + + + + + + +
+ + + + + O O O O O O + + + + +
+ + + + O O . . . . L O + + + +
+ + + + O . . . . . . O + + + +
+ + + + O . . .+o . . . O + + + +
# #+p L . . . . . . . . O + + + +
+ + + + O . . M0 M0 M0 M0 O + + + +
+ + + + O . . . . . . O + + + +
+ + + + O O . . . . O O + + + +
+ + + + + O O O O O O + + + + +
+ + + + + + + L + + + + + + + +
+ + + + + + + . G + + + + + + +
+ + + + + + + + + + + + + + + +
+ + + + + + + + + + + + + + + +