# # # # # # . . . . # # # # # #
# . . . . . . . p . . . . . . #
# . . . . . . . . . . . . . . #
# . . . . . . . . . . . . . . #
# . . . . . . . . . . . . . . #
# . . . . . . . . . o . O O O #
. . . . . . . . . . . . O . . .
. . . . . . . . . . . . O . . .
. . . . . . M0 M0 M1 . . . O . . .
. . . . . . M0 M1 M1 . . . O . . .
# . . . . . M0 M0 M1 . . . O O O #
# . . . . . . . . . . . . . . #
# . . . . . . . . . . . . . . #
# . . . . . . . . . . . . . . #
# . . . . . . . . . . . . . . #
# # # # # # # # # # # # # # # #