+ + + + + + + + + + + + + + + +
+ + + + + + + + + + + + + + + +
+ . . . . . . . . . . . . . . .
+ . . . . . # # # # . . . . . .
+ . . . O O # # # # + + + + + +
+ . . .+o O O # # # # + + + + + +
+ . . . . . O O O O . . . + # #
# # . . . . O O O O . M1 . + # #
# # . . . . O O O O . . . + # #
# # . . . . O O O O . . # . # #
+ # + + + + # # # # . . #+M2 . + +
+ # + + + + # #+M0 # # . . # . + +
+ # . . . . # # # # # # # # + +
+ # . . . . # # # # # # # # + +
+ # . p . . # # # # + + + + + +
+ # . . . . # # # # + + + + + +