+ # # # # # . . . . # # # # # +
+ # # . . . . . . . . . . . # +
+ # # . . . . . . . . . . . # +
+ . . . . . # # # # # . . . . +
+ . . . . . # . # # # . . . . +
+ # # # # # # . # # # . . . . +
+ # # # # # # . # L # . . + i +
+ # # # # # # . . . . . . + i +
+ # # # # l # # # # # # # + i +
+ + + . . . . . . . . . . + i +
+ + + . . . . . . . . . . + i +
+ + + . . . . . . . . . . . i +
+ + + . . . . . . . . . . # # +
.+# .+# .+# . . . . . p . . . . # # +
. . .+# . . . . . . . . . . # # +
.+# . # . . # .+# .+# .+# .+# # # # # # +