h h h h h h h h h h h h h h h h
h h h h h h h h h h h h h h h h
h h h h h . . . . h h h h h h h
h h h h h . . . . h h h h h h h
h h h h h h f f f h h h h h h h
h h h h . . . . . . h h h h h h
h h h h . . . . . . h h h h h h
h h h h . . h . . . . . . h h h
h h h h . . h . . h h h . h h h
h h h h h h h h h h h h . h h h
h h h h h h h h h h h h . h h h
h h h h h h h h h . . . . h h h
h h h h G # . . . . # h h h h h
h h h h h # . . p . # h h h h h
h h h h h # . . . . # h h h h h
h h h h h # . . . . # h h h h h