.+#+I+#+# . . . . . . . . . . . + + + +
. . . . . . . . . . . . + + + +
. . . . . . . . . . . . + + + +
. . . . . . . . . . . . + + + +
. . . . . . . . . . . . . . . .
. . . . . . . . . . . . . . . .
. . . . . . . . . . . . . . . .
. . . . . . . . . . . . . . + +
. . . . . . . . . . . . . . + +
. . . . . . . . . . . . . . + +
. . . . . . . . . . . . . . + +
. . . . . . . . . . . . . . + +
. . . . . . . . . . . . . . + +
. . . . . . . . . . . . . . + +
. . . . . . . . . . . . . . + +
+ + + + + + + + + + + + + + + +