+ + + + + + + + + + + + + + + +
+ . . . . . . . . . + + + + + +
+ . . . . . . . . . + + + + + +
+ . . . . . . . . . + + + + + +
+ . . . . . . . . . . . . . . .
+ . . . . . . . . . . . . . . .
+ . . . . . . . . . . . . . . .
+ . . . . . . . . . + + + + + +
+ . . . . . . . . . + + + + + +
+ . . . . . . . . . + + + + + +
+ . . . . . . . . . + + + + + +
+ . . . . . . . . . + + + + + +
+ . . . . . . . . . . . . . + +
+ . . . . . . . . . . . . . + +
+ . . . . . . . . . . . . . + +
+ + + + + + + + + + + + + + + +