# # # # # # . . . . # # + + + +
# . . . . . . . . . . . + + + +
# . . . . . . p . . . . + + + +
# . . . .+o . . . . . . . + + + +
# . . . . . . . M0 M0 . . + + + +
# O O . . . . . M0 M0 . . + + + +
. . O . . . . . . O O O # # # #
. . O . . . . . . O O O # # # #
. . O . . . . . . O O O # # # #
. . O . . . . . . O O O # # # #
# O O . . O O O . . . . + + + +
# . . . . O O O . . . . + + + +
# . M1 M1 . . . .+o . . . . + + + +
# . M1 M1 . . . . . . . . + + + +
# . . . . . . . . . . . + + + +
# # # # # # # # # # # # + + + +