#+sh # # # # # # . . . # # # # # #
# . . . + f . . . . . . . . . #
# . # # # # # # . . . . . . . #
# . . . . . M0 # . . . . . . . #
# . M0 M0 M0 M0 M0 # . . . . . . . #
# . . . . . M0 # + g g g g g g #
. . . . . . . + + . . . . # . .
. . . . . . . + + . . . . # p .
. . . . . . . + + . . . . # . .
. . . . . . . + + . . . . # . .
# # # . . # # # # g g g g g g #
# . . . . . . . . . . . . . . #
# . . . . . . . . . . . . . . #
# . . . . . . . . . . . . . . #
# . . . . . . . . . . . . . . #
# # # # # # #+sh # # # # # # # # #