+ + + . . + + + + + + . . + + +
+ + . . p + + + + + + . . + + +
+ + . . . . . . . f + . . f + .
+ + + + . . . . + + + + + + + +
+ + + f + + . . + + + + + + + +
+ + + . + + . . + + + + + + + +
# # # . . + f f + + + + . . + +
. . . . + + + + + + + + . f + +
. . . . + + . . + + + + . f # +
# # # . + + . . + + + + . . # +
+ + . . + + . . . + + + + . . #
+ + . f + + f . . + + + + + . #
+ + . . + + + + + + + + + + . #
+ + + + + + + + + + + + + + . #
+ + + + + . . f + . . f + . . #
# # # # # # # # # # # # # # # #