h h h h h # # . # # # # # # # #
h h h h h # i p i i i i # # # #
h h h # l i i i i i i # h h h h
h h h i i i i i i i # i h h h h
h i i i i i i i i l # L i h h h
. # i i i i i i i i i i i h h h
. l # i i i i i i i i i i L h h
. # # i i i l # # L i i i # h h
. L i i i i i i i i i i i l h h
. # i h i i i i i i i i i i h h
# # h h L # l i i i i l # i h h
h # i h i i i i # l i i i i h h
h # i h h i i i i i i i h i h h
h # l h h i i i i h h h h i h h
h i+# . i i i i i i i i i i l i+# h
h h h h h h h h h h h h h h h h