# # # # # # # # # # # # # # # #
# . . . . . . . . . . . . . . #
# . . . . . . . . . . . . . . #
# . . . . . . . . . . . . . . #
# . . . . . . . . . . . . . . #
# . . . . . . . . . . . . . . #
. . . . . . . . . . . . . . . #
. . . . . . . . . . . . . . . #
. . . . . . . . . . . . . . . #
. . . . . . . . . . . . . . . #
# . . . . . . . . . . . . . . #
# . . . . . . . . . . . . . . #
# . . . . . . . . . . . . . . #
# . . . . . . . . . . . . . . #
# . . . . . . . . . . . . . . #
# # # # # # # # # # # # # # # #