# # # # # # # # # #
# . . . . . # . . #
# . e # . . . . . #
# . . . . # # M1 . #
# . # . # i . M0 . #
# . . b . i # M0 i #
# . # b . i # . i #
# # p . . i . h h #
# . . . . # h h h #
# # # # # # # # # #
