+ + + + # + + + + + + + + + + +
# L + + #+p + + + + + + + + + + +
G . + + # + + + + + + + + + + +
+ + + + L + # # # # # # # # + +
+ + + . . . . . # . . . . . + +
+ + . . . . M0 . L . . . . . + +
+ + . . . . M0 . L . . . . . + +
+ . l l l . M0 . L . . . . . + +
+ . # # # # # # # . . . . . + +
+ . . . . . . . . . . . . . # #
+ + . . . . . . . . . . . . # #
+ + . . . . . . . . . . . . # #
+ + + + + . . + + + . . + + # #
. . . . M1 M1 . . + + + + + + # #
. # . . . M1 . . + + + + + + # #
# # # # # # # # # # # # # # # #