# # # # # # . . . . # # # # # #
# # # . . . . . p . . . . # # #
# # . . . . . . . . . . . . # #
# . . . . . . . . . . . . . . #
# i i i i i i i i i i i i i i #
# i i i i i i i i i i i i i i #
# # + + + + # # # i i i # + + #
# # + + + + # i i i i i # + + #
# i i i i i i i i # # # # # # #
# i i i i i i i i # # # # # # #
# . . . . # # # # # # . . . . #
# . . . . # # i i i i . . . . #
# . . . . i i i i i i . . . . #
# . . . . i i i i i i . . . . #
# . . . . # . . . . # . . . . #
# # # # # # . . . . # # # # # #