# # # # # # . . . . i+# # # # # #
# . . . . . . . . . . . . . . #
. . . . . . . p . . . . . . . #
# . . . M0 . . . . . . .+o . . . #
# . . . . . . . . . . . . . . #
# . . . . . . . . . . . . . . #
# # # # . . . . . . . . # # i #
# # # # O O O O O O O O # # i #
# # # # . . . . . . . . # # i #
# # # # . . . . . . . . # # i #
# # # # . . . . . . . . # # i #
# + + + . . . . . . . . . . i #
# + + + . . . . . . . . + + i #
# + + + . . . . . . . . + + i #
# + + + . . . . . . . . + + + #
# # # # # # . . . . # # # # # #