. . . . . . . . . . . . . . . .
. . . . . . . . . . . . . . . .
. . . . . . . . . . . . . . . .
. . . . . . . . . . . . . . . .
. . . . . . . . . . . . . . . .
. . . . . . . . . . . . . . . .
. . . . . . . . . . . . . . . .
. . . . . . . . . . . . i . . .
. . . . . . . . . . . . . . . .
. . . . . . . . . i . . . i . .
. . . . . . . . . . i . . i i i
. . . . . . . . . . . i i i i i
. . . . . . i . i . i i i i i i
. . . . . . . . . i i i i i i i
. . . . . . . i . i i i i i i i+I
. . . . . i . i i i i i i i i+I i+I