h # # # # # . . . . # h h h h h
h # . . . . . . . . # # h h h h
h # . . . . . p . . . # # h h h
# # . . . . . . . . . . # # h h
# . . . . . . . . . . . # # h h
. . . . . . . . . . . . . # # #
. . . . . . . . . . . . . . . .
. . . . . . . . . . . . . . . .
. . . . . . . . . . . . . . . .
. . . . . . . . . . . . . . . .
. . . . . . . . . . . . . . . .
. . . . . . . . . . . . . . . .
. . . . . . . . . . . . . . . .
. . . . . . . . . . . . . . . .
. . . . . . . . . . . . . . # #
. . . . . . . . . . . . . . h h