+ # # # # # . . . . # + + + + +
+ # . . . . . . . . # # + + + +
+ # . . . . . p . . . # # + + +
# # . . . . . . . . . . # # + +
# . . . . . . . . . . . # # + +
. . . . . . . . . . . . . # # #
. . . . . . . . . . . . . . . .
. . . . . . . . . . . . . . . .
. . . . . . . . . . . . . . . .
. . . . . . . . . . . . . . . .
. . . . . . . . . . . . . . . .
. . . . . . . . . . . . . . . .
. . . . . . . . . . . . . . . .
. . . . . . . . . . . . . . . .
. . . . . . . . . . . . . . # #
. . . . . . . . . . . . . . + +