# # # # # # . . . . # # # # # #
# . . . . . . . . . + + + + + #
# . . . . . . p . . + + + + + #
# . . f . . . . . . + + + + + #
# . . . . . . . . . + + + + + #
# . . . . + + + + + + + + + + #
# . . . . + + + + + + + + + + #
# . . . . + + + + + + + + + + #
# . . . . . . . + + + . . . . #
# . . . . . . . . + . . . . . #
# . . . . . . . + + + . . . . #
# + + + + + + + + + + + + . . #
# + + + + + + + + + + + + . . #
# + + + + + . . . . . . . . . #
# + + + + + . . . . . . . . . #
# # # # # # . . . . # # # # # #