.+# .+# .+# .+# .+# .+# . . . . .+# .+# .+# .+# .+# .+#
.+# . . . . . . . . . + + + + + .+#
.+# . . . . . . p . . + + + + + .+#
.+# . . f . . . . . . + + + + + .+#
.+# . . . . . . . . . + + + + + .+#
.+# . . . . + + + + + + + + + + .+#
.+# . . . . + + + + + + + + + + .+#
.+# . . . . + + + + + + + + + + .+#
.+# . . . . . . . + + + . . . . .+#
.+# . . . . . . . . + . . . . . .+#
.+# . . . . . . . + + + . . . . .+#
.+# + + + + + + + + + + + + . . .+#
.+# + + + + + + + + + + + + . . .+#
.+# + + + + + . . . . . . . . . .+#
.+# + + + + + . . . . . . . . . .+#
.+# .+# .+# .+# .+# .+# . . . . .+# .+# .+# .+# .+# .+#