+ + + + + + + + + + + + + + + +
+ + + + + + + + + + + + + + + +
+ + + + . . . . . . . . + + + +
+ + + . . L L . L L . . # # + +
+ . . . # L L . L L . # L # # +
+ i i # # L l L L L # # G # . .
+ i i # . L . L L L # . # . . .
+ i i # . L L L L L # . . . . p
+ i i # . L L L L L # . . . . .
+ i i # . L L L L L . . # # # .
+ i i . # . . . . l . L # l . #
+ . . . # # # # # . # # # . # +
+ + . . . . . . . # . . . . # +
+ + + . . l L L L . . . . # + +
+ + + + . . . . . # . . . # + +
+ + + + + + + + + # . . . # + +