+ + + + + + . . . . + + + + + +
+ + + + + + . . . . + + + + + +
+ + + + + + . p . . + + + + + +
+ + + + + + . . . . + + + + + +
# # # + + + + . + + + + + # # #
# # # + + + + f . . + + + # # #
. . . . + + + . + . + + + . . .
. . . . . + + f . . + + + . . .
. . . + + + + + + + + + + . . .
. . . + + + + + + + + + + . . .
# # # + + + + + + + + + + . . #
# # # + + + + + + + + + + . . #
# # # + + + + + + + + + + . . #
. . . . . . . . . . . . . . . #
. . . . . . . . . . . . . . . #
# # # # # # # # # # # # # # # #