+ + + + + . . . . . . . . . + +
+ + + + + . . . . . . . . . + +
+ + + + + + . . . . . . . . + +
+ + + + + + . . . . . . . . + +
+ + + + + + . . . . . . . . + +
+ + + + + + + . . . . . . + + +
+ + + + + + + . . . . . . + + +
+ + + + + + + . . . . . . + + +
+ + + + + + + . . . . . . + + +
.+# .+# .+# .+# + + + + . . . . + + + +
. . . .+# + + + + . . . . + + + +
. . . .+# + + + + . . . . + + + +
.+# .+# .+# .+# + + + + . . . . + + + +
+ + + + + + + + + . . + + + + +
+ + + + + + + + + . . + + + + +
+ + + + + + + + + . . + + + + +