# # # # # # . . . . # # h h h h
# . . . . . . . . . . . h h h h
# . . . . . . p . . . . h h h h
# . . . .+o . . . . . . . h h h h
# . . . . . . . M0 M0 . . h h h h
# O O . . . . . M0 M0 . . h h h h
. . O . . . . . . O O O # # # #
. . O . . . . . . O O O # # # #
. . O . . . . . . O O O # # # #
. . O . . . . . . O O O # # # #
# O O . . O O O . . . . h h h h
# . . . . O O O . . . . h h h h
# . M1 M1 . . . .+o . . . . h h h h
# . M1 M1 . . . . . . . . h h h h
# . . . . . . . . . . . h h h h
# # # # # # # # # # # # h h h h