# # # # # # . . . . # # # # # #
# # # # # # . . . . i i i i i #
# # # # # # # # # # # # # # i #
# # # i i i i i i i i i # # i #
# # # i # # # # # # # i # # i #
# # # i # # # # # # # i # # i #
# # # i # # i i i i i i i # i #
# # # i # # i i i i i i i # i #
# # # i i i i i i i i i i # i #
# # # # # # i i i i i i i i i #
# . . . . # i i i i i i i # i #
# . M0 M0 . # i i i i i i i # i #
# . M0 M0 . # # . . # # # # # i i+#
# . . . . . . . . . . . . . i h
# . . . . . . . p . . . . . i h
# # # # # # . . . . # # # # # #